NO textures/mossy_cobblestone1.xpm
SO textures/netherrack_01.xpm
WE textures/mycelium_top.xpm
EA textures/os.xpm

F 50,100,100
C 25,30,100

111111111111111111111111111111
1S0000000000000011111111111
100000001110000000000000111
1000001101100000000000001111
1000011001100000000000000001
10001111111110000000000000001
110000000110000011100111111111
101000000110000111100111111
100100000100000000000011
100010000100000000000011
10000000010000000000011
100000000100000011111111111
100000001110000000000000111
1000001101100000010000001111
1000011001100000010000000001
10001111111110000100000000001
100000000110000011100111111111
100000000110000111100111111
100000000000010000000011
100000000000010100000011
100000000000010100000011
1111111111111111111111