NO textures/eagle.xpm
SO textures/greystone.xpm
WE textures/purplestone.xpm
EA textures/red.xpm
F 100,100,0
C 000,30,0

11111111111111
10000000010101
1000V000000001
100V000V010101
100000V0010101
10000000010101
10000001010101
10000000000101
1001P1P1010101
10000000000001
1000N000000101
11111111111111